11111111
00000000
10111101
11100111
10100101
11101101
11110101
10101111
10110111
10101101
11100101
10100111
10110101
10010100
00000111
11100000
00101001
10100000
00100001
10000100
00000101
10000111
10110100
00101101
11100001
11111101
11110111
11101111
10111111
00100100
10000001
10000000
00100000
00000100
00000001
00101111
10010111
11101001
11110100
10101001
11100100
10010101
00100111
00100101
10100001
10000101
10100100
w11100111
W11100111
e11100111
W10100101
s10111101
W10111101
n10111101